aspect,negative,neutral,positive,total_mentions,positive_ratio,neutral_ratio,negative_ratio
0,1,0,1,2,0.5,0.0,0.5
1800,0,1,0,1,0.0,1.0,0.0
2004,1,0,0,1,0.0,0.0,1.0
2004 edition,1,0,0,1,0.0,0.0,1.0
2004 version,0,0,1,1,1.0,0.0,0.0
3650,0,1,0,1,0.0,1.0,0.0
3d,1,0,0,1,0.0,0.0,1.0
4mp,0,0,2,2,1.0,0.0,0.0
4mp camera,0,0,1,1,1.0,0.0,0.0
4mp resolution,0,0,1,1,1.0,0.0,0.0
5day forecaster,0,0,1,1,1.0,0.0,0.0
640x480 mode,0,0,1,1,1.0,0.0,0.0
6600,3,8,3,14,0.21428571428571427,0.5714285714285714,0.21428571428571427
8mb,0,0,1,1,1.0,0.0,0.0
8mb card,0,0,1,1,1.0,0.0,0.0
access,0,0,3,3,1.0,0.0,0.0
access point,0,1,0,1,0.0,1.0,0.0
accessible,0,0,1,1,1.0,0.0,0.0
accessing file,0,0,1,1,1.0,0.0,0.0
accessories,0,9,1,10,0.1,0.9,0.0
accessory,1,0,2,3,0.6666666666666666,0.0,0.3333333333333333
acer,0,3,0,3,0.0,1.0,0.0
acer monitor,0,0,1,1,1.0,0.0,0.0
acer netbook aspire one,0,0,1,1,1.0,0.0,0.0
acer product,0,1,0,1,0.0,1.0,0.0
acer products,1,0,0,1,0.0,0.0,1.0
acer tech support,0,1,0,1,0.0,1.0,0.0
acer widescreen,0,0,1,1,1.0,0.0,0.0
activation process,0,0,1,1,1.0,0.0,0.0
ad1220,0,0,1,1,1.0,0.0,0.0
ad1600,0,0,1,1,1.0,0.0,0.0
adapter,1,1,0,2,0.0,0.5,0.5
additional accesories,0,0,1,1,1.0,0.0,0.0
adjust,0,1,1,2,0.5,0.5,0.0
adjustment,6,4,3,13,0.23076923076923078,0.3076923076923077,0.46153846153846156
adjustments,1,1,0,2,0.0,0.5,0.5
administration,0,0,1,1,1.0,0.0,0.0
adustment knob,0,0,1,1,1.0,0.0,0.0
advanced controls,0,1,0,1,0.0,1.0,0.0
aff,0,0,1,1,1.0,0.0,0.0
affordability,0,1,0,1,0.0,1.0,0.0
affordable,1,1,0,2,0.0,0.5,0.5
alerts,2,0,0,2,0.0,0.0,1.0
alternative,0,0,1,1,1.0,0.0,0.0
amazon,3,0,1,4,0.25,0.0,0.75
amplifier,0,0,1,1,1.0,0.0,0.0
anteanna,0,0,1,1,1.0,0.0,0.0
antenna,1,0,0,1,0.0,0.0,1.0
antispam,2,1,0,3,0.0,0.3333333333333333,0.6666666666666666
antivirus,3,2,0,5,0.0,0.4,0.6
antivirus software,1,0,0,1,0.0,0.0,1.0
apex,4,2,4,10,0.4,0.2,0.4
appeal,1,0,0,1,0.0,0.0,1.0
appearance,0,1,0,1,0.0,1.0,0.0
apple,1,0,5,6,0.8333333333333334,0.0,0.16666666666666666
application,1,2,2,5,0.4,0.4,0.2
applications,1,2,1,4,0.25,0.5,0.25
arm band,1,0,0,1,0.0,0.0,1.0
assemble,1,0,0,1,0.0,0.0,1.0
att,1,0,0,1,0.0,0.0,1.0
att customer service,0,1,0,1,0.0,1.0,0.0
audio bar,0,0,1,1,1.0,0.0,0.0
audio cube,1,0,0,1,0.0,0.0,1.0
audio formats,0,0,1,1,1.0,0.0,0.0
audio output,0,0,1,1,1.0,0.0,0.0
audio quality,0,0,5,5,1.0,0.0,0.0
audio volume,0,0,1,1,1.0,0.0,0.0
auto color balance,0,0,1,1,1.0,0.0,0.0
auto fit,0,1,0,1,0.0,1.0,0.0
auto load,0,1,0,1,0.0,1.0,0.0
auto mode,3,2,6,11,0.5454545454545454,0.18181818181818182,0.2727272727272727
auto setting,1,1,2,4,0.5,0.25,0.25
autofocus,1,3,1,5,0.2,0.6,0.2
autofocus assist light,0,0,1,1,1.0,0.0,0.0
automatic modes,0,0,1,1,1.0,0.0,0.0
automatic settings,1,0,0,1,0.0,0.0,1.0
automode,0,1,0,1,0.0,1.0,0.0
av 2004,0,0,1,1,1.0,0.0,0.0
avr 525,0,1,0,1,0.0,1.0,0.0
back,1,0,1,2,0.5,0.0,0.5
back cover,0,0,1,1,1.0,0.0,0.0
background,1,0,0,1,0.0,0.0,1.0
background light,0,0,1,1,1.0,0.0,0.0
backlight,2,2,1,5,0.2,0.4,0.4
backlighting,0,0,1,1,1.0,0.0,0.0
backward,0,1,0,1,0.0,1.0,0.0
backward compatible,0,1,0,1,0.0,1.0,0.0
bag,2,2,0,4,0.0,0.5,0.5
bags,0,2,1,3,0.3333333333333333,0.6666666666666666,0.0
balance,1,0,1,2,0.5,0.0,0.5
band,0,1,0,1,0.0,1.0,0.0
bandwidth hogging software,0,1,0,1,0.0,1.0,0.0
bangforthebuck,0,1,0,1,0.0,1.0,0.0
bargins,0,1,0,1,0.0,1.0,0.0
base,0,1,1,2,0.5,0.5,0.0
bass,5,3,16,24,0.6666666666666666,0.125,0.20833333333333334
bass controls,0,0,1,1,1.0,0.0,0.0
bass level,0,0,1,1,1.0,0.0,0.0
bass quality,0,0,1,1,1.0,0.0,0.0
bass tones,0,0,1,1,1.0,0.0,0.0
battery,55,27,59,141,0.41843971631205673,0.19148936170212766,0.3900709219858156
battery charger,1,0,0,1,0.0,0.0,1.0
battery charging,1,0,0,1,0.0,0.0,1.0
battery charging system,0,1,0,1,0.0,1.0,0.0
battery replacement,0,0,1,1,1.0,0.0,0.0
battery top,1,0,0,1,0.0,0.0,1.0
battery usage,0,1,1,2,0.5,0.5,0.0
batterylife,0,0,1,1,1.0,0.0,0.0
beeps,1,0,0,1,0.0,0.0,1.0
belt clip,1,0,2,3,0.6666666666666666,0.0,0.3333333333333333
beltclip design,0,0,1,1,1.0,0.0,0.0
bestbuilt,0,0,1,1,1.0,0.0,0.0
big,1,2,0,3,0.0,0.6666666666666666,0.3333333333333333
bigger,0,2,0,2,0.0,1.0,0.0
blocking,2,0,0,2,0.0,0.0,1.0
bluetooth modules,0,0,1,1,1.0,0.0,0.0
body,3,0,1,4,0.25,0.0,0.75
bog,2,0,0,2,0.0,0.0,1.0
bookmakr,1,0,0,1,0.0,0.0,1.0
bookmark,2,0,0,2,0.0,0.0,1.0
boot,0,1,0,1,0.0,1.0,0.0
booting,1,0,0,1,0.0,0.0,1.0
breaks,1,0,0,1,0.0,0.0,1.0
bright,0,0,2,2,1.0,0.0,0.0
brightness,1,1,3,5,0.6,0.2,0.2
broadband,0,1,0,1,0.0,1.0,0.0
broadcom hardware,0,1,0,1,0.0,1.0,0.0
browsing,0,0,1,1,1.0,0.0,0.0
buffalo technical support line,0,0,1,1,1.0,0.0,0.0
bufflo nfinity g300n,0,1,0,1,0.0,1.0,0.0
build quality,0,0,1,1,1.0,0.0,0.0
built,1,1,1,3,0.3333333333333333,0.3333333333333333,0.3333333333333333
bulky,0,1,1,2,0.5,0.5,0.0
bundled software,0,0,1,1,1.0,0.0,0.0
button,5,5,6,16,0.375,0.3125,0.3125
button functioning,1,0,0,1,0.0,0.0,1.0
buttons,6,1,4,11,0.36363636363636365,0.09090909090909091,0.5454545454545454
cable,0,1,0,1,0.0,1.0,0.0
cable hook ups,0,0,1,1,1.0,0.0,0.0
calendar,0,1,0,1,0.0,1.0,0.0
call,1,0,0,1,0.0,0.0,1.0
call logs,1,0,0,1,0.0,0.0,1.0
calls,3,1,0,4,0.0,0.25,0.75
camera,49,47,100,196,0.5102040816326531,0.23979591836734693,0.25
camera quality,0,0,2,2,1.0,0.0,0.0
camera shake,0,0,1,1,1.0,0.0,0.0
cameras,1,0,1,2,0.5,0.0,0.5
canera,0,0,1,1,1.0,0.0,0.0
canon,2,0,1,3,0.3333333333333333,0.0,0.6666666666666666
canon g3,1,0,0,1,0.0,0.0,1.0
cap,0,0,1,1,1.0,0.0,0.0
capacity,5,3,2,10,0.2,0.3,0.5
car adapter,0,1,0,1,0.0,1.0,0.0
carpet tacks,0,0,1,1,1.0,0.0,0.0
carrier,1,0,0,1,0.0,0.0,1.0
case,16,7,1,24,0.041666666666666664,0.2916666666666667,0.6666666666666666
casing,0,1,2,3,0.6666666666666666,0.3333333333333333,0.0
cd,2,6,2,10,0.2,0.6,0.2
cd audio disc,0,0,1,1,1.0,0.0,0.0
cd burner,1,0,0,1,0.0,0.0,1.0
cd rip,0,4,0,4,0.0,1.0,0.0
champ,1,5,8,14,0.5714285714285714,0.35714285714285715,0.07142857142857142
change,2,0,2,4,0.5,0.0,0.5
charge,2,0,0,2,0.0,0.0,1.0
charged,0,1,0,1,0.0,1.0,0.0
charger,1,0,0,1,0.0,0.0,1.0
charging,1,1,0,2,0.0,0.5,0.5
chat support,1,0,0,1,0.0,0.0,1.0
cheap,1,2,3,6,0.5,0.3333333333333333,0.16666666666666666
cheaper,0,0,1,1,1.0,0.0,0.0
cheapest,0,0,1,1,1.0,0.0,0.0
cheep,0,1,0,1,0.0,1.0,0.0
chinese name,0,1,0,1,0.0,1.0,0.0
chuck,1,1,0,2,0.0,0.5,0.5
cisco valet,0,1,0,1,0.0,1.0,0.0
clarity,1,1,1,3,0.3333333333333333,0.3333333333333333,0.3333333333333333
clean,0,2,1,3,0.3333333333333333,0.6666666666666666,0.0
click buttons,0,0,1,1,1.0,0.0,0.0
click wheel,1,0,2,3,0.6666666666666666,0.0,0.3333333333333333
clicker,0,0,1,1,1.0,0.0,0.0
clip,0,1,0,1,0.0,1.0,0.0
clips,0,0,1,1,1.0,0.0,0.0
closeup mode,0,1,0,1,0.0,1.0,0.0
closeup shooting,0,0,1,1,1.0,0.0,0.0
code,0,0,1,1,1.0,0.0,0.0
collet,1,3,2,6,0.3333333333333333,0.5,0.16666666666666666
collets,0,2,0,2,0.0,1.0,0.0
color,6,3,6,15,0.4,0.2,0.4
color and light,0,0,1,1,1.0,0.0,0.0
color balance,0,0,1,1,1.0,0.0,0.0
color display,1,0,0,1,0.0,0.0,1.0
color rendering,0,0,1,1,1.0,0.0,0.0
color screen,2,0,1,3,0.3333333333333333,0.0,0.6666666666666666
color signal,0,0,1,1,1.0,0.0,0.0
color tft display,0,1,0,1,0.0,1.0,0.0
colors,3,3,6,12,0.5,0.25,0.25
com book compatibility,1,0,0,1,0.0,0.0,1.0
come back online,1,0,0,1,0.0,0.0,1.0
comfort,0,2,0,2,0.0,1.0,0.0
command,0,0,1,1,1.0,0.0,0.0
compact,1,6,0,7,0.0,0.8571428571428571,0.14285714285714285
compactflash,0,0,1,1,1.0,0.0,0.0
company,0,0,1,1,1.0,0.0,0.0
compatibility,1,0,2,3,0.6666666666666666,0.0,0.3333333333333333
compatibility with windows media player,0,1,0,1,0.0,1.0,0.0
components,3,0,1,4,0.25,0.0,0.75
components and directions,0,0,1,1,1.0,0.0,0.0
computer,2,1,4,7,0.5714285714285714,0.14285714285714285,0.2857142857142857
computer associates ez,0,0,1,1,1.0,0.0,0.0
computer speaker,0,0,3,3,1.0,0.0,0.0
computer speakers,1,0,2,3,0.6666666666666666,0.0,0.3333333333333333
condition,1,1,0,2,0.0,0.5,0.5
configuration,1,2,1,4,0.25,0.5,0.25
configuration menu,0,0,1,1,1.0,0.0,0.0
configuration options,0,1,0,1,0.0,1.0,0.0
configure,1,0,0,1,0.0,0.0,1.0
connect,1,4,1,6,0.16666666666666666,0.6666666666666666,0.16666666666666666
connected,0,1,0,1,0.0,1.0,0.0
connection options,0,1,0,1,0.0,1.0,0.0
connection speed,0,0,1,1,1.0,0.0,0.0
connection speeds,0,0,1,1,1.0,0.0,0.0
connections,0,1,1,2,0.5,0.5,0.0
connectivity,16,12,9,37,0.24324324324324326,0.32432432432432434,0.43243243243243246
connectivity bars,1,0,0,1,0.0,0.0,1.0
construction,5,6,5,16,0.3125,0.375,0.3125
container,0,0,1,1,1.0,0.0,0.0
continuous shot mode,0,0,1,1,1.0,0.0,0.0
contrast,1,1,2,4,0.5,0.25,0.25
control,14,14,8,36,0.2222222222222222,0.3888888888888889,0.3888888888888889
control station,1,0,0,1,0.0,0.0,1.0
controller,0,0,1,1,1.0,0.0,0.0
controls,4,3,3,10,0.3,0.3,0.4
convenient,1,1,0,2,0.0,0.5,0.5
converter,0,0,1,1,1.0,0.0,0.0
copy large files,0,0,1,1,1.0,0.0,0.0
cord,0,0,1,1,1.0,0.0,0.0
corporate,1,0,0,1,0.0,0.0,1.0
corporate edition,1,0,0,1,0.0,0.0,1.0
corsair,1,0,0,1,0.0,0.0,1.0
cost effective,0,0,1,1,1.0,0.0,0.0
costlier,0,0,1,1,1.0,0.0,0.0
costly,0,0,1,1,1.0,0.0,0.0
costs,0,1,0,1,0.0,1.0,0.0
cover,0,1,2,3,0.6666666666666666,0.3333333333333333,0.0
coverage,2,3,0,5,0.0,0.6,0.4
covering,0,0,1,1,1.0,0.0,0.0
creative,1,3,0,4,0.0,0.75,0.25
creative product,1,0,0,1,0.0,0.0,1.0
creative zen,0,1,0,1,0.0,1.0,0.0
creative zen micro,0,1,0,1,0.0,1.0,0.0
crispness,0,0,1,1,1.0,0.0,0.0
crossship,0,1,0,1,0.0,1.0,0.0
csr,1,0,0,1,0.0,0.0,1.0
customer care,0,1,0,1,0.0,1.0,0.0
customer rep,1,0,0,1,0.0,0.0,1.0
customer service,18,6,4,28,0.14285714285714285,0.21428571428571427,0.6428571428571429
customer service agents,1,0,0,1,0.0,0.0,1.0
customer service reps,0,1,0,1,0.0,1.0,0.0
customer support,1,4,1,6,0.16666666666666666,0.6666666666666666,0.16666666666666666
customer support website,1,0,0,1,0.0,0.0,1.0
cuts,1,1,0,2,0.0,0.5,0.5
darn diopter adjustment dial,1,0,0,1,0.0,0.0,1.0
data rate,1,0,0,1,0.0,0.0,1.0
ddwrt firmware,0,0,1,1,1.0,0.0,0.0
ddwrt software,0,1,0,1,0.0,1.0,0.0
dead pixels,0,1,0,1,0.0,1.0,0.0
deal,1,2,1,4,0.25,0.5,0.25
default ringtone,0,1,0,1,0.0,1.0,0.0
definition sound,0,0,1,1,1.0,0.0,0.0
delay,2,2,1,5,0.2,0.4,0.4
delete,0,1,0,1,0.0,1.0,0.0
delivering,0,0,1,1,1.0,0.0,0.0
delivery,2,0,0,2,0.0,0.0,1.0
dependability,0,1,0,1,0.0,1.0,0.0
depth,1,1,1,3,0.3333333333333333,0.3333333333333333,0.3333333333333333
depths,1,0,0,1,0.0,0.0,1.0
design,32,38,37,107,0.34579439252336447,0.35514018691588783,0.29906542056074764
designed,0,1,1,2,0.5,0.5,0.0
desktop card,0,1,0,1,0.0,1.0,0.0
desktops,0,1,0,1,0.0,1.0,0.0
device,4,4,2,10,0.2,0.4,0.4
devices,0,0,1,1,1.0,0.0,0.0
devise,0,1,0,1,0.0,1.0,0.0
dhcp,0,0,1,1,1.0,0.0,0.0
dial,2,1,0,3,0.0,0.3333333333333333,0.6666666666666666
dialogue,0,0,1,1,1.0,0.0,0.0
dialogues,0,1,0,1,0.0,1.0,0.0
diaper,3,0,2,5,0.4,0.0,0.6
diaper champ,6,7,15,28,0.5357142857142857,0.25,0.21428571428571427
diaper dekor,0,1,0,1,0.0,1.0,0.0
diaper genie,2,1,0,3,0.0,0.3333333333333333,0.6666666666666666
diaper pail,8,3,2,13,0.15384615384615385,0.23076923076923078,0.6153846153846154
diaper wipes,0,0,2,2,1.0,0.0,0.0
diapers,3,1,2,6,0.3333333333333333,0.16666666666666666,0.5
different file,1,0,0,1,0.0,0.0,1.0
digic ii chip,0,0,1,1,1.0,0.0,0.0
digital camera,0,0,1,1,1.0,0.0,0.0
digital zoom,0,1,1,2,0.5,0.5,0.0
direct elictrical connectivity,1,0,0,1,0.0,0.0,1.0
direction,0,0,1,1,1.0,0.0,0.0
disc,1,1,1,3,0.3333333333333333,0.3333333333333333,0.3333333333333333
disconnect,0,1,0,1,0.0,1.0,0.0
disconnecting,0,1,0,1,0.0,1.0,0.0
disconnects,0,0,1,1,1.0,0.0,0.0
disign,0,1,0,1,0.0,1.0,0.0
disk,1,0,0,1,0.0,0.0,1.0
disney movie,0,0,1,1,1.0,0.0,0.0
displays,0,1,0,1,0.0,1.0,0.0
dispose,0,2,0,2,0.0,1.0,0.0
distort,1,0,0,1,0.0,0.0,1.0
distortion,0,1,1,2,0.5,0.5,0.0
divx rip,0,0,1,1,1.0,0.0,0.0
dj,0,0,1,1,1.0,0.0,0.0
dlink,0,1,1,2,0.5,0.5,0.0
dlink dir655,0,0,1,1,1.0,0.0,0.0
dlink dir655 extreme n wireless router,0,0,1,1,1.0,0.0,0.0
dlink support,1,0,0,1,0.0,0.0,1.0
dlink support crew,1,0,0,1,0.0,0.0,1.0
documentatio,0,0,1,1,1.0,0.0,0.0
documentation,2,2,1,5,0.2,0.4,0.4
door,2,2,0,4,0.0,0.5,0.5
download,2,3,0,5,0.0,0.6,0.4
download speed,1,0,0,1,0.0,0.0,1.0
downloads,1,0,0,1,0.0,0.0,1.0
drawings,0,0,1,1,1.0,0.0,0.0
drivers,1,0,0,1,0.0,0.0,1.0
dsl modem,1,0,0,1,0.0,0.0,1.0
dsub cord,0,1,0,1,0.0,1.0,0.0
duallayer dvd,1,0,0,1,0.0,0.0,1.0
durability,2,1,2,5,0.4,0.2,0.4
durable,0,1,1,2,0.5,0.5,0.0
duration,1,0,0,1,0.0,0.0,1.0
dvd,6,7,13,26,0.5,0.2692307692307692,0.23076923076923078
dvd disc,0,0,1,1,1.0,0.0,0.0
dvd media,0,1,0,1,0.0,1.0,0.0
dvd player,3,6,3,12,0.25,0.5,0.25
dvdr,0,0,4,4,1.0,0.0,0.0
dvi connection,1,0,0,1,0.0,0.0,1.0
dynamic range,1,0,0,1,0.0,0.0,1.0
e100s,0,1,0,1,0.0,1.0,0.0
e90s,0,1,0,1,0.0,1.0,0.0
ear,1,0,0,1,0.0,0.0,1.0
ear buds,0,0,1,1,1.0,0.0,0.0
ear phone jack,0,0,1,1,1.0,0.0,0.0
ear volume,1,0,0,1,0.0,0.0,1.0
earbud,5,2,2,9,0.2222222222222222,0.2222222222222222,0.5555555555555556
earbuds,1,1,4,6,0.6666666666666666,0.16666666666666666,0.16666666666666666
earphone,1,1,1,3,0.3333333333333333,0.3333333333333333,0.3333333333333333
earphones,0,0,1,1,1.0,0.0,0.0
earpiece,3,0,0,3,0.0,0.0,1.0
ease of usage,1,0,0,1,0.0,0.0,1.0
ease of use,1,1,8,10,0.8,0.1,0.1
ease ofuse,0,0,1,1,1.0,0.0,0.0
eax,5,2,3,10,0.3,0.2,0.5
eax mode,1,0,0,1,0.0,0.0,1.0
edges,0,0,1,1,1.0,0.0,0.0
editing titles,1,0,0,1,0.0,0.0,1.0
effective,0,0,1,1,1.0,0.0,0.0
elph s100,0,0,1,1,1.0,0.0,0.0
email,0,0,1,1,1.0,0.0,0.0
email spam,0,0,1,1,1.0,0.0,0.0
empty,2,0,0,2,0.0,0.0,1.0
emptying,1,0,0,1,0.0,0.0,1.0
enterprise piece,0,0,1,1,1.0,0.0,0.0
enviromental audio,0,0,1,1,1.0,0.0,0.0
equalizer,0,2,1,3,0.3333333333333333,0.6666666666666666,0.0
equilizer,1,0,0,1,0.0,0.0,1.0
equipment,1,2,1,4,0.25,0.5,0.25
ergonomics,0,0,1,1,1.0,0.0,0.0
ethernet transceiver,0,1,0,1,0.0,1.0,0.0
exchange period,0,1,0,1,0.0,1.0,0.0
expandability,1,0,0,1,0.0,0.0,1.0
expensive,3,1,0,4,0.0,0.25,0.75
explain,0,1,0,1,0.0,1.0,0.0
explorer,0,1,0,1,0.0,1.0,0.0
exposure,0,1,1,2,0.5,0.5,0.0
exposure control,0,0,1,1,1.0,0.0,0.0
external display,1,0,0,1,0.0,0.0,1.0
external flash hot shoe,1,0,0,1,0.0,0.0,1.0
external switch,1,0,0,1,0.0,0.0,1.0
extra accessories,0,0,1,1,1.0,0.0,0.0
extra features,1,2,0,3,0.0,0.6666666666666666,0.3333333333333333
face plate,1,0,0,1,0.0,0.0,1.0
faster,1,0,1,2,0.5,0.0,0.5
feature,9,15,17,41,0.4146341463414634,0.36585365853658536,0.21951219512195122
features,9,10,19,38,0.5,0.2631578947368421,0.23684210526315788
feel,4,2,4,10,0.4,0.2,0.4
feels,2,1,0,3,0.0,0.3333333333333333,0.6666666666666666
fence,1,0,1,2,0.5,0.0,0.5
file limit,1,0,0,1,0.0,0.0,1.0
file transfer,1,1,3,5,0.6,0.2,0.2
file transfer speed,0,0,1,1,1.0,0.0,0.0
fill,0,0,1,1,1.0,0.0,0.0
filp,1,0,0,1,0.0,0.0,1.0
finding,0,1,1,2,0.5,0.5,0.0
finish,2,1,1,4,0.25,0.25,0.5
firewall,3,1,1,5,0.2,0.2,0.6
firewire,2,1,1,4,0.25,0.25,0.5
firmware,3,5,3,11,0.2727272727272727,0.45454545454545453,0.2727272727272727
firmware update,1,2,2,5,0.4,0.4,0.2
firmware upgrade,0,0,2,2,1.0,0.0,0.0
fit,1,1,1,3,0.3333333333333333,0.3333333333333333,0.3333333333333333
fit into the socket,0,0,1,1,1.0,0.0,0.0
fits,4,2,0,6,0.0,0.3333333333333333,0.6666666666666666
flash,3,2,5,10,0.5,0.2,0.3
flash photo,0,1,0,1,0.0,1.0,0.0
flip side,1,0,0,1,0.0,0.0,1.0
flip switch,0,1,0,1,0.0,1.0,0.0
fly wheel,1,0,0,1,0.0,0.0,1.0
flywheel,0,0,1,1,1.0,0.0,0.0
fm,1,2,0,3,0.0,0.6666666666666666,0.3333333333333333
fm radio,0,0,1,1,1.0,0.0,0.0
fm receiver,0,1,1,2,0.5,0.5,0.0
fm reception,2,3,3,8,0.375,0.375,0.25
fm tuner,1,1,2,4,0.5,0.25,0.25
focus,2,0,4,6,0.6666666666666666,0.0,0.3333333333333333
focuses,1,0,0,1,0.0,0.0,1.0
folder,2,0,2,4,0.5,0.0,0.5
folder structure,2,1,0,3,0.0,0.3333333333333333,0.6666666666666666
fonts,0,0,2,2,1.0,0.0,0.0
form,0,1,0,1,0.0,1.0,0.0
format,2,5,5,12,0.4166666666666667,0.4166666666666667,0.16666666666666666
formats,0,0,1,1,1.0,0.0,0.0
forward,0,0,2,2,1.0,0.0,0.0
four megapixel,0,0,1,1,1.0,0.0,0.0
fragments,1,0,0,1,0.0,0.0,1.0
freespeak,1,0,0,1,0.0,0.0,1.0
freeze,0,2,0,2,0.0,1.0,0.0
freezes,1,0,0,1,0.0,0.0,1.0
freezing,0,0,1,1,1.0,0.0,0.0
front channels,0,0,1,1,1.0,0.0,0.0
front cover,1,0,0,1,0.0,0.0,1.0
fun,0,1,0,1,0.0,1.0,0.0
function,1,2,1,4,0.25,0.5,0.25
functionality,1,2,2,5,0.4,0.4,0.2
functioning,0,1,3,4,0.75,0.25,0.0
functions,1,0,0,1,0.0,0.0,1.0
g3,0,5,1,6,0.16666666666666666,0.8333333333333334,0.0
game,0,3,4,7,0.5714285714285714,0.42857142857142855,0.0
games,5,2,2,9,0.2222222222222222,0.2222222222222222,0.5555555555555556
garbage bags,0,2,1,3,0.3333333333333333,0.6666666666666666,0.0
gift,1,0,0,1,0.0,0.0,1.0
go online,0,1,0,1,0.0,1.0,0.0
gprs,1,2,0,3,0.0,0.6666666666666666,0.3333333333333333
gpu hardware acceleration,1,0,0,1,0.0,0.0,1.0
grain,0,0,1,1,1.0,0.0,0.0
grip,1,0,0,1,0.0,0.0,1.0
gsm,0,0,1,1,1.0,0.0,0.0
guest feature,0,1,0,1,0.0,1.0,0.0
guest network,1,0,0,1,0.0,0.0,1.0
gui,1,0,0,1,0.0,0.0,1.0
guide,0,1,2,3,0.6666666666666666,0.3333333333333333,0.0
hand set,1,0,0,1,0.0,0.0,1.0
handsfree,0,0,1,1,1.0,0.0,0.0
hang,0,0,1,1,1.0,0.0,0.0
hard drive,3,0,4,7,0.5714285714285714,0.0,0.42857142857142855
hardcase,0,0,1,1,1.0,0.0,0.0
hardware version,0,0,1,1,1.0,0.0,0.0
hdmi output,0,0,1,1,1.0,0.0,0.0
headphone,4,2,2,8,0.25,0.25,0.5
headphone jack,6,4,3,13,0.23076923076923078,0.3076923076923077,0.46153846153846156
headphones,2,6,5,13,0.38461538461538464,0.46153846153846156,0.15384615384615385
headset,0,1,0,1,0.0,1.0,0.0
headset jack,0,0,1,1,1.0,0.0,0.0
hear,0,1,0,1,0.0,1.0,0.0
heat,1,0,1,2,0.5,0.0,0.5
heat dissipation,0,0,1,1,1.0,0.0,0.0
heat up,0,0,1,1,1.0,0.0,0.0
heated,0,0,1,1,1.0,0.0,0.0
heavier,0,1,0,1,0.0,1.0,0.0
heavy,2,3,5,10,0.5,0.3,0.2
heft,0,0,1,1,1.0,0.0,0.0
height,0,0,1,1,1.0,0.0,0.0
height adjustability,0,0,1,1,1.0,0.0,0.0
help,2,0,0,2,0.0,0.0,1.0
helpline,1,0,0,1,0.0,0.0,1.0
high speed internet,0,1,0,1,0.0,1.0,0.0
highlight,1,0,0,1,0.0,0.0,1.0
highs,1,2,0,3,0.0,0.6666666666666666,0.3333333333333333
hitachi,1,1,0,2,0.0,0.5,0.5
hitachi m12v,1,0,0,1,0.0,0.0,1.0
hold,0,1,0,1,0.0,1.0,0.0
holds,1,0,2,3,0.6666666666666666,0.0,0.3333333333333333
hole,0,0,1,1,1.0,0.0,0.0
home network,1,0,0,1,0.0,0.0,1.0
home theater,1,0,0,1,0.0,0.0,1.0
home version,2,0,0,2,0.0,0.0,1.0
hook up,0,1,0,1,0.0,1.0,0.0
horn tweeters,1,0,0,1,0.0,0.0,1.0
horns,1,0,0,1,0.0,0.0,1.0
hot,0,2,0,2,0.0,1.0,0.0
hot shoe flash,0,0,1,1,1.0,0.0,0.0
housing,0,2,0,2,0.0,1.0,0.0
ht upgrade,0,0,1,1,1.0,0.0,0.0
id3,0,1,0,1,0.0,1.0,0.0
id3 tag,3,3,1,7,0.14285714285714285,0.42857142857142855,0.42857142857142855
image download,0,1,0,1,0.0,1.0,0.0
image quality,0,0,3,3,1.0,0.0,0.0
images,1,1,2,4,0.5,0.25,0.25
import,0,1,0,1,0.0,1.0,0.0
incompatibility,0,1,1,2,0.5,0.5,0.0
increased memory option,1,0,0,1,0.0,0.0,1.0
indoor image,1,0,0,1,0.0,0.0,1.0
indoor picture,0,0,1,1,1.0,0.0,0.0
indoor shot,0,0,3,3,1.0,0.0,0.0
inexpensive,1,0,1,2,0.5,0.0,0.5
infrared,0,0,2,2,1.0,0.0,0.0
input,0,0,1,1,1.0,0.0,0.0
install,6,6,8,20,0.4,0.3,0.3
installation,8,11,5,24,0.20833333333333334,0.4583333333333333,0.3333333333333333
installation software,0,1,0,1,0.0,1.0,0.0
installed,0,0,1,1,1.0,0.0,0.0
installing,0,2,0,2,0.0,1.0,0.0
installs,1,0,0,1,0.0,0.0,1.0
instant messaging,0,1,0,1,0.0,1.0,0.0
instant setup,0,1,0,1,0.0,1.0,0.0
instruction,4,1,2,7,0.2857142857142857,0.14285714285714285,0.5714285714285714
instruction booklet,1,0,0,1,0.0,0.0,1.0
instructions,3,7,3,13,0.23076923076923078,0.5384615384615384,0.23076923076923078
instructions manual,1,0,0,1,0.0,0.0,1.0
insurance,0,0,1,1,1.0,0.0,0.0
interface,13,14,10,37,0.2702702702702703,0.3783783783783784,0.35135135135135137
internet,2,1,1,4,0.25,0.25,0.5
internet connection,2,3,1,6,0.16666666666666666,0.5,0.3333333333333333
internet connectivity,0,0,1,1,1.0,0.0,0.0
internet security,1,1,2,4,0.5,0.25,0.25
internet signal,0,1,0,1,0.0,1.0,0.0
internet user manual,0,0,1,1,1.0,0.0,0.0
intrusion,2,0,0,2,0.0,0.0,1.0
investment,0,0,1,1,1.0,0.0,0.0
ipod,7,2,8,17,0.47058823529411764,0.11764705882352941,0.4117647058823529
isync,1,0,0,1,0.0,0.0,1.0
isync compaibility,0,0,2,2,1.0,0.0,0.0
item,1,1,1,3,0.3333333333333333,0.3333333333333333,0.3333333333333333
items,0,1,0,1,0.0,1.0,0.0
itunes,5,7,4,16,0.25,0.4375,0.3125
jbl s310 ii,0,0,1,1,1.0,0.0,0.0
jbl sub,1,0,0,1,0.0,0.0,1.0
jewel,0,1,0,1,0.0,1.0,0.0
jog dial,1,0,0,1,0.0,0.0,1.0
joints,1,0,0,1,0.0,0.0,1.0
joy stick,2,0,0,2,0.0,0.0,1.0
joystick,0,0,3,3,1.0,0.0,0.0
jpeg,0,0,3,3,1.0,0.0,0.0
jpeg picture,1,0,0,1,0.0,0.0,1.0
jpeg slideshow,0,0,1,1,1.0,0.0,0.0
junk,1,0,0,1,0.0,0.0,1.0
kays,1,0,0,1,0.0,0.0,1.0
key,3,3,0,6,0.0,0.5,0.5
key lock,0,1,0,1,0.0,1.0,0.0
keyboard,0,2,3,5,0.6,0.4,0.0
keyboard connector,0,1,0,1,0.0,1.0,0.0
keypad,0,0,4,4,1.0,0.0,0.0
keys,1,2,0,3,0.0,0.6666666666666666,0.3333333333333333
klipsh subwoofer,0,1,0,1,0.0,1.0,0.0
knob,0,0,1,1,1.0,0.0,0.0
labeling of firmware,1,0,0,1,0.0,0.0,1.0
labling,0,0,1,1,1.0,0.0,0.0
lag,1,1,0,2,0.0,0.5,0.5
lag time,0,1,0,1,0.0,1.0,0.0
laid out,1,0,0,1,0.0,0.0,1.0
laptop,1,1,1,3,0.3333333333333333,0.3333333333333333,0.3333333333333333
large,0,1,0,1,0.0,1.0,0.0
last,0,1,0,1,0.0,1.0,0.0
latch,1,0,0,1,0.0,0.0,1.0
layout,0,1,0,1,0.0,1.0,0.0
lcd monitor,1,1,0,2,0.0,0.5,0.5
learn,0,1,0,1,0.0,1.0,0.0
learning,0,0,1,1,1.0,0.0,0.0
learning curve,1,0,0,1,0.0,0.0,1.0
leather case,1,0,1,2,0.5,0.0,0.5
leather pouch,0,1,0,1,0.0,1.0,0.0
led monitor,0,0,1,1,1.0,0.0,0.0
lens,0,0,4,4,1.0,0.0,0.0
lens cap,4,0,0,4,0.0,0.0,1.0
lens cover,0,0,1,1,1.0,0.0,0.0
lense,0,0,1,1,1.0,0.0,0.0
lense cap,0,0,1,1,1.0,0.0,0.0
lever,0,1,0,1,0.0,1.0,0.0
life,0,0,1,1,1.0,0.0,0.0
light,1,0,3,4,0.75,0.0,0.25
light auto correction,0,1,0,1,0.0,1.0,0.0
lighter,1,0,1,2,0.5,0.0,0.5
lightweight,1,0,1,2,0.5,0.0,0.5
line out jack,1,0,1,2,0.5,0.0,0.5
lines,0,1,0,1,0.0,1.0,0.0
linksys,0,4,2,6,0.3333333333333333,0.6666666666666666,0.0
lipsync,0,0,1,1,1.0,0.0,0.0
liveupdate,3,0,0,3,0.0,0.0,1.0
load,0,1,0,1,0.0,1.0,0.0
load time,1,0,0,1,0.0,0.0,1.0
loading,0,1,0,1,0.0,1.0,0.0
loading speed,1,0,0,1,0.0,0.0,1.0
local hd decoding,0,0,1,1,1.0,0.0,0.0
lock,0,0,1,1,1.0,0.0,0.0
lock feature,0,0,1,1,1.0,0.0,0.0
lock up,0,2,1,3,0.3333333333333333,0.6666666666666666,0.0
logging,0,1,0,1,0.0,1.0,0.0
logitech production values,0,0,1,1,1.0,0.0,0.0
looked,0,1,0,1,0.0,1.0,0.0
looking,1,3,3,7,0.42857142857142855,0.42857142857142855,0.14285714285714285
looks,2,4,4,10,0.4,0.4,0.2
loud,1,0,1,2,0.5,0.0,0.5
loud phone,0,0,1,1,1.0,0.0,0.0
low light focus,1,0,0,1,0.0,0.0,1.0
lowlight conditions,0,1,0,1,0.0,1.0,0.0
lows,0,1,0,1,0.0,1.0,0.0
m12,0,1,0,1,0.0,1.0,0.0
m12v,1,0,1,2,0.5,0.0,0.5
mac support,0,0,1,1,1.0,0.0,0.0
machine,4,3,3,10,0.3,0.3,0.4
macro,1,0,3,4,0.75,0.0,0.25
macro mode,0,2,1,3,0.3333333333333333,0.6666666666666666,0.0
macrosresults,0,0,1,1,1.0,0.0,0.0
made,0,2,0,2,0.0,1.0,0.0
make,0,0,1,1,1.0,0.0,0.0
manual,3,4,4,11,0.36363636363636365,0.36363636363636365,0.2727272727272727
manual control,1,0,0,1,0.0,0.0,1.0
manual controls,0,1,0,1,0.0,1.0,0.0
manual mode,0,5,2,7,0.2857142857142857,0.7142857142857143,0.0
manual modes,1,0,0,1,0.0,0.0,1.0
manual shutdown,0,0,1,1,1.0,0.0,0.0
material,1,1,0,2,0.0,0.5,0.5
mcafee antivirus 8,0,0,1,1,1.0,0.0,0.0
media,1,0,0,1,0.0,0.0,1.0
media player compatibility,0,1,0,1,0.0,1.0,0.0
mediasource,0,3,2,5,0.4,0.6,0.0
memory,12,13,20,45,0.4444444444444444,0.28888888888888886,0.26666666666666666
memory card,3,1,0,4,0.0,0.25,0.75
memory expansion,0,1,0,1,0.0,1.0,0.0
memory stick slots,0,0,1,1,1.0,0.0,0.0
memory usage,0,2,1,3,0.3333333333333333,0.6666666666666666,0.0
menu,9,4,8,21,0.38095238095238093,0.19047619047619047,0.42857142857142855
menu dial knob,0,0,1,1,1.0,0.0,0.0
menu option,1,0,0,1,0.0,0.0,1.0
menu options,0,1,0,1,0.0,1.0,0.0
menue,1,0,0,1,0.0,0.0,1.0
menus,2,0,0,2,0.0,0.0,1.0
merge pictures,0,0,1,1,1.0,0.0,0.0
message,0,2,0,2,0.0,1.0,0.0
metal case,0,1,0,1,0.0,1.0,0.0
metering option,0,0,1,1,1.0,0.0,0.0
mhz,0,1,0,1,0.0,1.0,0.0
micro,0,1,0,1,0.0,1.0,0.0
microphone,1,1,0,2,0.0,0.5,0.5
midrange,0,1,1,2,0.5,0.5,0.0
mids,1,1,0,2,0.0,0.5,0.5
mmc,1,0,0,1,0.0,0.0,1.0
mmc card,0,2,0,2,0.0,1.0,0.0
mmc memory,0,0,1,1,1.0,0.0,0.0
mmc slot,0,0,1,1,1.0,0.0,0.0
mms,0,0,1,1,1.0,0.0,0.0
mode,0,2,0,2,0.0,1.0,0.0
model,2,0,1,3,0.3333333333333333,0.0,0.6666666666666666
model router,0,0,1,1,1.0,0.0,0.0
modem,0,0,1,1,1.0,0.0,0.0
money,2,3,1,6,0.16666666666666666,0.5,0.3333333333333333
monitors,2,1,0,3,0.0,0.3333333333333333,0.6666666666666666
motor,0,1,1,2,0.5,0.5,0.0
motorola t720i,1,0,0,1,0.0,0.0,1.0
mount,0,0,1,1,1.0,0.0,0.0
mounting abilities,0,0,1,1,1.0,0.0,0.0
mouse,0,0,1,1,1.0,0.0,0.0
mouse pad,0,0,1,1,1.0,0.0,0.0
movie,0,1,1,2,0.5,0.5,0.0
movie mode,1,0,2,3,0.6666666666666666,0.0,0.3333333333333333
movies,0,2,0,2,0.0,1.0,0.0
mp3,0,1,0,1,0.0,1.0,0.0
mp3 filename,1,0,0,1,0.0,0.0,1.0
mp3 player,0,2,2,4,0.5,0.5,0.0
mpeg,0,2,0,2,0.0,1.0,0.0
mpeg1,0,0,1,1,1.0,0.0,0.0
multimedia,0,1,0,1,0.0,1.0,0.0
multimedia functions,0,1,0,1,0.0,1.0,0.0
multiple picture,0,1,0,1,0.0,1.0,0.0
multiple pictures,0,1,0,1,0.0,1.0,0.0
multipurpose,0,0,1,1,1.0,0.0,0.0
music,0,1,0,1,0.0,1.0,0.0
music quality,0,0,1,1,1.0,0.0,0.0
music source support,0,0,1,1,1.0,0.0,0.0
music speaker,1,0,0,1,0.0,0.0,1.0
music subscription service,0,0,1,1,1.0,0.0,0.0
music transfer,0,0,1,1,1.0,0.0,0.0
musicmatch software,0,1,0,1,0.0,1.0,0.0
n550 speaker lapdesk,0,0,1,1,1.0,0.0,0.0
name,0,0,1,1,1.0,0.0,0.0
napster,0,1,0,1,0.0,1.0,0.0
napster 2 go compatibility,0,0,1,1,1.0,0.0,0.0
napster to go compatibility,0,0,1,1,1.0,0.0,0.0
navigate,1,0,0,1,0.0,0.0,1.0
navigatee,1,0,0,1,0.0,0.0,1.0
navigating,0,0,1,1,1.0,0.0,0.0
navigation,8,6,5,19,0.2631578947368421,0.3157894736842105,0.42105263157894735
navigational system,0,1,0,1,0.0,1.0,0.0
netbook,0,3,3,6,0.5,0.5,0.0
netgear genie tool,0,0,1,1,1.0,0.0,0.0
network,1,0,2,3,0.6666666666666666,0.0,0.3333333333333333
network speeds,0,0,1,1,1.0,0.0,0.0
night mode,0,0,1,1,1.0,0.0,0.0
nikon,1,0,1,2,0.5,0.0,0.5
nikon 4300,0,0,1,1,1.0,0.0,0.0
nikon support,0,0,1,1,1.0,0.0,0.0
nimble,0,0,1,1,1.0,0.0,0.0
nis,0,1,1,2,0.5,0.5,0.0
nis 04,0,0,1,1,1.0,0.0,0.0
nis 2003,0,0,1,1,1.0,0.0,0.0
nis 2004,1,1,0,2,0.0,0.5,0.5
nis2004,0,1,0,1,0.0,1.0,0.0
no disc,1,3,3,7,0.42857142857142855,0.42857142857142855,0.14285714285714285
noise,5,1,0,6,0.0,0.16666666666666666,0.8333333333333334
nokia,6,1,3,10,0.3,0.1,0.6
nomad,1,3,1,5,0.2,0.6,0.2
nomad explorer,0,2,2,4,0.5,0.5,0.0
nooff button,1,0,0,1,0.0,0.0,1.0
norton,3,5,4,12,0.3333333333333333,0.4166666666666667,0.25
norton antispam,1,0,0,1,0.0,0.0,1.0
norton internet security,1,0,0,1,0.0,0.0,1.0
norton products,0,0,1,1,1.0,0.0,0.0
norton program,0,1,0,1,0.0,1.0,0.0
norton site,0,0,1,1,1.0,0.0,0.0
notmad,0,1,0,1,0.0,1.0,0.0
notmad software,1,0,0,1,0.0,0.0,1.0
nrouter,0,0,1,1,1.0,0.0,0.0
nstalling,0,1,0,1,0.0,1.0,0.0
number buttons,0,1,0,1,0.0,1.0,0.0
oderous,1,0,0,1,0.0,0.0,1.0
odor,4,5,5,14,0.35714285714285715,0.35714285714285715,0.2857142857142857
odors,2,1,1,4,0.25,0.25,0.5
off,0,1,0,1,0.0,1.0,0.0
off button,1,0,0,1,0.0,0.0,1.0
office starter web cam,1,0,0,1,0.0,0.0,1.0
on,0,1,0,1,0.0,1.0,0.0
oncamera controls,0,0,1,1,1.0,0.0,0.0
onkyo sound,0,0,1,1,1.0,0.0,0.0
online help,1,0,0,1,0.0,0.0,1.0
online service,0,0,1,1,1.0,0.0,0.0
online support,0,1,0,1,0.0,1.0,0.0
onscreen display,1,0,0,1,0.0,0.0,1.0
open,2,1,1,4,0.25,0.25,0.5
opening,0,0,2,2,1.0,0.0,0.0
operate,0,2,2,4,0.5,0.5,0.0
operated,0,1,0,1,0.0,1.0,0.0
operating system,0,1,0,1,0.0,1.0,0.0
operation,0,3,0,3,0.0,1.0,0.0
operation interfaces,0,0,1,1,1.0,0.0,0.0
optic,0,0,2,2,1.0,0.0,0.0
optical setting,1,0,0,1,0.0,0.0,1.0
optical zoom,2,1,6,9,0.6666666666666666,0.1111111111111111,0.2222222222222222
option,0,1,2,3,0.6666666666666666,0.3333333333333333,0.0
options,1,0,0,1,0.0,0.0,1.0
organization,1,1,0,2,0.0,0.5,0.5
organizer,1,0,0,1,0.0,0.0,1.0
os,3,1,1,5,0.2,0.2,0.6
other pail,0,0,1,1,1.0,0.0,0.0
outlook compatibility,0,0,1,1,1.0,0.0,0.0
outlook sync,1,0,0,1,0.0,0.0,1.0
output,0,1,0,1,0.0,1.0,0.0
outside finish,0,1,0,1,0.0,1.0,0.0
overall,0,1,0,1,0.0,1.0,0.0
p button,1,0,0,1,0.0,0.0,1.0
package,0,0,1,1,1.0,0.0,0.0
packaged,0,1,0,1,0.0,1.0,0.0
packing,0,0,1,1,1.0,0.0,0.0
pail,2,0,3,5,0.6,0.0,0.4
pair,0,0,1,1,1.0,0.0,0.0
paired,0,0,1,1,1.0,0.0,0.0
panel,0,0,2,2,1.0,0.0,0.0
panel button layout,0,0,1,1,1.0,0.0,0.0
panorama mode,1,0,0,1,0.0,0.0,1.0
panorama modes,1,0,0,1,0.0,0.0,1.0
panorama setting,0,0,1,1,1.0,0.0,0.0
parental control,0,1,0,1,0.0,1.0,0.0
parental controls,1,0,0,1,0.0,0.0,1.0
pause,0,0,1,1,1.0,0.0,0.0
pay,0,0,1,1,1.0,0.0,0.0
pc software,0,0,1,1,1.0,0.0,0.0
pc suite,0,1,0,1,0.0,1.0,0.0
pc sync,0,0,1,1,1.0,0.0,0.0
pda,0,2,0,2,0.0,1.0,0.0
perform,0,0,2,2,1.0,0.0,0.0
performance,13,26,21,60,0.35,0.43333333333333335,0.21666666666666667
performer,1,0,0,1,0.0,0.0,1.0
performs,0,1,0,1,0.0,1.0,0.0
phillip speaker sound,1,0,0,1,0.0,0.0,1.0
phone,33,32,50,115,0.43478260869565216,0.2782608695652174,0.28695652173913044
phone book,0,1,0,1,0.0,1.0,0.0
phone card calling,0,1,1,2,0.5,0.5,0.0
phone performance,0,1,0,1,0.0,1.0,0.0
phones,1,2,0,3,0.0,0.6666666666666666,0.3333333333333333
photo quality,2,2,2,6,0.3333333333333333,0.3333333333333333,0.3333333333333333
photo viewing,0,0,1,1,1.0,0.0,0.0
photos,0,2,2,4,0.5,0.5,0.0
pics,3,1,1,5,0.2,0.2,0.6
picture,18,12,29,59,0.4915254237288136,0.2033898305084746,0.3050847457627119
picture clarity,0,0,1,1,1.0,0.0,0.0
picture detail,0,0,1,1,1.0,0.0,0.0
picture quality,6,7,10,23,0.43478260869565216,0.30434782608695654,0.2608695652173913
picture sharing,0,1,0,1,0.0,1.0,0.0
pictures of people,0,0,1,1,1.0,0.0,0.0
pim,0,0,1,1,1.0,0.0,0.0
pinnacle speaker bar,0,0,1,1,1.0,0.0,0.0
pipeline,1,0,0,1,0.0,0.0,1.0
pixel quality,0,0,1,1,1.0,0.0,0.0
pixels,0,1,0,1,0.0,1.0,0.0
plan,0,1,0,1,0.0,1.0,0.0
play,10,10,6,26,0.23076923076923078,0.38461538461538464,0.38461538461538464
play mode,0,0,2,2,1.0,0.0,0.0
play option,0,1,0,1,0.0,1.0,0.0
play wma,1,1,0,2,0.0,0.5,0.5
playback quality,0,0,2,2,1.0,0.0,0.0
player,88,51,88,227,0.3876651982378855,0.22466960352422907,0.3876651982378855
player hardware,0,0,1,1,1.0,0.0,0.0
playlist,3,4,5,12,0.4166666666666667,0.3333333333333333,0.25
playlists,0,1,0,1,0.0,1.0,0.0
plug,1,0,0,1,0.0,0.0,1.0
plug and play,1,0,0,1,0.0,0.0,1.0
plug in,0,1,0,1,0.0,1.0,0.0
pluger,1,0,0,1,0.0,0.0,1.0
plunge,1,5,0,6,0.0,0.8333333333333334,0.16666666666666666
plunger,1,0,0,1,0.0,0.0,1.0
plunging,4,0,1,5,0.2,0.0,0.8
popup blocker,1,0,0,1,0.0,0.0,1.0
popup face,1,0,0,1,0.0,0.0,1.0
popups,0,1,0,1,0.0,1.0,0.0
port translation,0,0,1,1,1.0,0.0,0.0
portability,1,1,2,4,0.5,0.25,0.25
portable,2,1,1,4,0.25,0.25,0.5
pouch,0,1,0,1,0.0,1.0,0.0
power,8,4,5,17,0.29411764705882354,0.23529411764705882,0.47058823529411764
power button,0,0,1,1,1.0,0.0,0.0
power supply,2,0,0,2,0.0,0.0,1.0
powerful,1,0,1,2,0.5,0.0,0.5
powers up,0,1,0,1,0.0,1.0,0.0
powerup,0,1,1,2,0.5,0.5,0.0
precise,0,0,1,1,1.0,0.0,0.0
preform,0,1,0,1,0.0,1.0,0.0
preset,0,0,1,1,1.0,0.0,0.0
pretty,1,0,1,2,0.5,0.0,0.5
price,44,34,42,120,0.35,0.2833333333333333,0.36666666666666664
price point,1,0,0,1,0.0,0.0,1.0
priced,1,2,0,3,0.0,0.6666666666666666,0.3333333333333333
pricess,0,0,1,1,1.0,0.0,0.0
pricey,0,1,0,1,0.0,1.0,0.0
print,0,3,2,5,0.4,0.6,0.0
print quality,0,1,0,1,0.0,1.0,0.0
printer sharing,0,1,0,1,0.0,1.0,0.0
prints,1,0,1,2,0.5,0.0,0.5
priority id,1,0,0,1,0.0,0.0,1.0
processing,1,0,0,1,0.0,0.0,1.0
processor,2,0,0,2,0.0,0.0,1.0
product,28,32,30,90,0.3333333333333333,0.35555555555555557,0.3111111111111111
products,1,3,2,6,0.3333333333333333,0.5,0.16666666666666666
professional version,1,0,0,1,0.0,0.0,1.0
program,1,2,2,5,0.4,0.4,0.2
program scan,1,0,0,1,0.0,0.0,1.0
programs,0,1,0,1,0.0,1.0,0.0
progressive scan,1,0,1,2,0.5,0.0,0.5
properties,0,1,0,1,0.0,1.0,0.0
proprietary,0,1,0,1,0.0,1.0,0.0
pull,1,0,0,1,0.0,0.0,1.0
purchase,0,1,1,2,0.5,0.5,0.0
purchases,0,1,0,1,0.0,1.0,0.0
quality,9,11,15,35,0.42857142857142855,0.3142857142857143,0.2571428571428571
quality issue,0,0,1,1,1.0,0.0,0.0
quality item,1,0,0,1,0.0,0.0,1.0
quality of audio,0,1,0,1,0.0,1.0,0.0
quality of picture,1,0,0,1,0.0,0.0,1.0
quality product,0,0,1,1,1.0,0.0,0.0
quality service,0,1,0,1,0.0,1.0,0.0
quality tower speaker,0,0,1,1,1.0,0.0,0.0
quest wireless,0,1,0,1,0.0,1.0,0.0
quiet,2,0,1,3,0.3333333333333333,0.0,0.6666666666666666
quite,0,1,0,1,0.0,1.0,0.0
radio,3,3,10,16,0.625,0.1875,0.1875
radio feature,1,0,0,1,0.0,0.0,1.0
radio record,0,0,1,1,1.0,0.0,0.0
radio tuner,0,1,0,1,0.0,1.0,0.0
range,2,5,5,12,0.4166666666666667,0.4166666666666667,0.16666666666666666
range of response,1,0,0,1,0.0,0.0,1.0
rate plan,0,0,1,1,1.0,0.0,0.0
raw format,0,0,1,1,1.0,0.0,0.0
raw image,0,0,1,1,1.0,0.0,0.0
read,2,3,6,11,0.5454545454545454,0.2727272727272727,0.18181818181818182
readability,0,0,1,1,1.0,0.0,0.0
rebate,0,5,0,5,0.0,1.0,0.0
rebates,1,0,0,1,0.0,0.0,1.0
reboots,0,0,1,1,1.0,0.0,0.0
reception,4,4,6,14,0.42857142857142855,0.2857142857142857,0.2857142857142857
rechargeable battery,1,0,0,1,0.0,0.0,1.0
recharger,1,0,0,1,0.0,0.0,1.0
reciever,1,0,0,1,0.0,0.0,1.0
recognition,1,0,0,1,0.0,0.0,1.0
recorded,0,0,1,1,1.0,0.0,0.0
recording,1,0,0,1,0.0,0.0,1.0
redeye,0,0,1,1,1.0,0.0,0.0
refills,2,6,3,11,0.2727272727272727,0.5454545454545454,0.18181818181818182
reformatted,0,1,0,1,0.0,1.0,0.0
refund,1,0,0,1,0.0,0.0,1.0
reinstall,0,1,0,1,0.0,1.0,0.0
reliability,1,2,1,4,0.25,0.5,0.25
reliable,0,0,2,2,1.0,0.0,0.0
remote,2,5,7,14,0.5,0.35714285714285715,0.14285714285714285
remote control,2,0,2,4,0.5,0.0,0.5
remote layout,1,0,0,1,0.0,0.0,1.0
removal program,1,0,0,1,0.0,0.0,1.0
remove,2,0,1,3,0.3333333333333333,0.0,0.6666666666666666
rename,0,0,1,1,1.0,0.0,0.0
repair technicians,1,0,1,2,0.5,0.0,0.5
replaceable battery,0,1,0,1,0.0,1.0,0.0
replacement,1,0,0,1,0.0,0.0,1.0
reset,0,1,0,1,0.0,1.0,0.0
resolution,1,1,2,4,0.5,0.25,0.25
resolution setting,0,1,0,1,0.0,1.0,0.0
responce,0,1,0,1,0.0,1.0,0.0
response speed,0,0,1,1,1.0,0.0,0.0
result,0,1,0,1,0.0,1.0,0.0
return policy,1,0,0,1,0.0,0.0,1.0
rewind,0,1,0,1,0.0,1.0,0.0
ring,1,0,1,2,0.5,0.0,0.5
ring tone,0,1,1,2,0.5,0.5,0.0
ringer,0,0,1,1,1.0,0.0,0.0
ringers,1,0,0,1,0.0,0.0,1.0
rings,0,0,1,1,1.0,0.0,0.0
ringtone,3,1,4,8,0.5,0.125,0.375
ringtones,0,2,2,4,0.5,0.5,0.0
rip,0,2,1,3,0.3333333333333333,0.6666666666666666,0.0
rip cd,0,1,0,1,0.0,1.0,0.0
rip software,0,0,1,1,1.0,0.0,0.0
room,1,0,0,1,0.0,0.0,1.0
router,27,30,36,93,0.3870967741935484,0.3225806451612903,0.2903225806451613
router razier,0,0,1,1,1.0,0.0,0.0
routers,0,1,0,1,0.0,1.0,0.0
rugged,0,1,0,1,0.0,1.0,0.0
run,1,1,2,4,0.5,0.25,0.25
rundown time,0,0,1,1,1.0,0.0,0.0
running,1,0,1,2,0.5,0.0,0.5
runs,1,1,1,3,0.3333333333333333,0.3333333333333333,0.3333333333333333
s products,0,0,1,1,1.0,0.0,0.0
s100,0,2,3,5,0.6,0.4,0.0
safer,0,1,0,1,0.0,1.0,0.0
safety,1,2,0,3,0.0,0.6666666666666666,0.3333333333333333
satellite,0,0,1,1,1.0,0.0,0.0
satellite speakers,0,0,1,1,1.0,0.0,0.0
satellites,0,1,1,2,0.5,0.5,0.0
sawdust,0,0,2,2,1.0,0.0,0.0
scan,0,1,0,1,0.0,1.0,0.0
scanning,0,1,0,1,0.0,1.0,0.0
scene mode,0,2,3,5,0.6,0.4,0.0
scratch,0,0,2,2,1.0,0.0,0.0
scratches,1,0,2,3,0.6666666666666666,0.0,0.3333333333333333
screen,46,26,39,111,0.35135135135135137,0.23423423423423423,0.4144144144144144
screen brightness,0,0,1,1,1.0,0.0,0.0
screen functions,0,0,1,1,1.0,0.0,0.0
screen quality,0,1,1,2,0.5,0.5,0.0
screen resolution,0,1,0,1,0.0,1.0,0.0
screen review,0,0,1,1,1.0,0.0,0.0
screen saver,1,0,0,1,0.0,0.0,1.0
screens,0,1,0,1,0.0,1.0,0.0
screensaver,1,0,0,1,0.0,0.0,1.0
screw tip,1,0,0,1,0.0,0.0,1.0
scroll,9,3,3,15,0.2,0.2,0.6
scroll bar,1,0,1,2,0.5,0.0,0.5
scroll wheel,7,0,4,11,0.36363636363636365,0.0,0.6363636363636364
scrollpad,1,0,0,1,0.0,0.0,1.0
sd500,0,0,3,3,1.0,0.0,0.0
seal,0,0,1,1,1.0,0.0,0.0
securespot,0,0,1,1,1.0,0.0,0.0
security,0,3,3,6,0.5,0.5,0.0
security settings,0,1,0,1,0.0,1.0,0.0
security suite,0,1,0,1,0.0,1.0,0.0
selector buttons,0,0,1,1,1.0,0.0,0.0
semelled,1,0,0,1,0.0,0.0,1.0
sensitive,1,0,0,1,0.0,0.0,1.0
sensitivy,0,0,1,1,1.0,0.0,0.0
service,4,2,2,8,0.25,0.25,0.5
service tech,0,0,1,1,1.0,0.0,0.0
servicing,1,0,0,1,0.0,0.0,1.0
set,0,2,0,2,0.0,1.0,0.0
set up,8,16,2,26,0.07692307692307693,0.6153846153846154,0.3076923076923077
setting,0,1,1,2,0.5,0.5,0.0
setting up,0,1,0,1,0.0,1.0,0.0
settings,0,0,1,1,1.0,0.0,0.0
setup,3,17,7,27,0.25925925925925924,0.6296296296296297,0.1111111111111111
setup disk,1,0,0,1,0.0,0.0,1.0
setup software,0,2,0,2,0.0,1.0,0.0
shaft,1,0,0,1,0.0,0.0,1.0
shafts,2,0,0,2,0.0,0.0,1.0
shape,3,1,1,5,0.2,0.2,0.6
shareport,1,1,0,2,0.0,0.5,0.5
shareport utility,0,0,1,1,1.0,0.0,0.0
sharp,0,0,1,1,1.0,0.0,0.0
sheer volume,0,1,0,1,0.0,1.0,0.0
shipped out,1,0,0,1,0.0,0.0,1.0
shipping,1,1,1,3,0.3333333333333333,0.3333333333333333,0.3333333333333333
shipping service,0,1,0,1,0.0,1.0,0.0
shoot,1,0,0,1,0.0,0.0,1.0
shot,1,0,0,1,0.0,0.0,1.0
shots,0,1,0,1,0.0,1.0,0.0
shuffle,0,1,0,1,0.0,1.0,0.0
shuttle,0,1,0,1,0.0,1.0,0.0
side view,0,0,1,1,1.0,0.0,0.0
signal,2,3,4,9,0.4444444444444444,0.3333333333333333,0.2222222222222222
signal interruptions,1,0,0,1,0.0,0.0,1.0
signal quality,0,1,1,2,0.5,0.5,0.0
signal strength,1,2,1,4,0.25,0.5,0.25
signal strengths,0,0,1,1,1.0,0.0,0.0
signal to noise ratio,0,0,1,1,1.0,0.0,0.0
signals,0,0,2,2,1.0,0.0,0.0
silver plate,0,1,0,1,0.0,1.0,0.0
simcard,0,1,0,1,0.0,1.0,0.0
simple,0,1,0,1,0.0,1.0,0.0
size,45,63,50,158,0.31645569620253167,0.3987341772151899,0.2848101265822785
sleek,0,1,0,1,0.0,1.0,0.0
slop,0,1,0,1,0.0,1.0,0.0
slowed down,0,1,0,1,0.0,1.0,0.0
slower,0,1,0,1,0.0,1.0,0.0
smal,0,0,1,1,1.0,0.0,0.0
small,5,4,11,20,0.55,0.2,0.25
smaller,0,0,2,2,1.0,0.0,0.0
smallest,0,1,0,1,0.0,1.0,0.0
smell,1,4,2,7,0.2857142857142857,0.5714285714285714,0.14285714285714285
smelling,1,0,0,1,0.0,0.0,1.0
smells,1,0,0,1,0.0,0.0,1.0
smooth,2,0,0,2,0.0,0.0,1.0
snapshots,1,1,0,2,0.0,0.5,0.5
software,31,43,45,119,0.37815126050420167,0.36134453781512604,0.2605042016806723
solid,0,0,1,1,1.0,0.0,0.0
solid feel,0,1,0,1,0.0,1.0,0.0
solidity,0,0,1,1,1.0,0.0,0.0
song quality,0,0,1,1,1.0,0.0,0.0
song speed,0,0,1,1,1.0,0.0,0.0
sony,0,0,1,1,1.0,0.0,0.0
sony ericsson t610,0,1,0,1,0.0,1.0,0.0
sonyericsson,1,0,0,1,0.0,0.0,1.0
sorting,0,0,1,1,1.0,0.0,0.0
sound,64,38,63,165,0.38181818181818183,0.23030303030303031,0.3878787878787879
sound effects,0,0,1,1,1.0,0.0,0.0
sound option,0,1,0,1,0.0,1.0,0.0
sound quality,22,15,21,58,0.3620689655172414,0.25862068965517243,0.3793103448275862
sound reproduction,0,0,1,1,1.0,0.0,0.0
sound setting,0,1,0,1,0.0,1.0,0.0
sound system,1,0,1,2,0.5,0.0,0.5
sound volume,1,0,0,1,0.0,0.0,1.0
sounded,1,0,0,1,0.0,0.0,1.0
sounds,2,1,5,8,0.625,0.125,0.25
spam,1,0,0,1,0.0,0.0,1.0
spam killer,0,1,0,1,0.0,1.0,0.0
speaker bar,0,0,2,2,1.0,0.0,0.0
speaker cable,1,0,0,1,0.0,0.0,1.0
speaker crossovers,0,0,1,1,1.0,0.0,0.0
speaker grill,0,1,0,1,0.0,1.0,0.0
speaker mount,2,0,0,2,0.0,0.0,1.0
speaker phone,2,3,2,7,0.2857142857142857,0.42857142857142855,0.2857142857142857
speaker set,0,0,1,1,1.0,0.0,0.0
speaker stands,0,0,1,1,1.0,0.0,0.0
speaker system,1,1,2,4,0.5,0.25,0.25
speaker wire,0,0,2,2,1.0,0.0,0.0
speaker wire hookups,1,0,0,1,0.0,0.0,1.0
speakerphone,0,10,6,16,0.375,0.625,0.0
speakers,22,4,17,43,0.3953488372093023,0.09302325581395349,0.5116279069767442
speeds,1,2,1,4,0.25,0.5,0.25
spindle,0,1,0,1,0.0,1.0,0.0
spot metering,0,0,1,1,1.0,0.0,0.0
spring,0,0,2,2,1.0,0.0,0.0
springs,1,1,0,2,0.0,0.5,0.5
sprint,0,0,1,1,1.0,0.0,0.0
sprint customer service,0,0,1,1,1.0,0.0,0.0
sprint plan,0,0,1,1,1.0,0.0,0.0
srorage,0,1,0,1,0.0,1.0,0.0
stability,1,0,1,2,0.5,0.0,0.5
stable,1,0,3,4,0.75,0.0,0.25
stand,1,2,1,4,0.25,0.5,0.25
stands,1,1,4,6,0.6666666666666666,0.16666666666666666,0.16666666666666666
start,1,1,2,4,0.5,0.25,0.25
start up,0,0,1,1,1.0,0.0,0.0
starts,1,1,0,2,0.0,0.5,0.5
starts up,0,0,1,1,1.0,0.0,0.0
steel backing,1,0,0,1,0.0,0.0,1.0
stereo reproduction,0,1,0,1,0.0,1.0,0.0
stereo separation,1,0,0,1,0.0,0.0,1.0
stinky,1,0,0,1,0.0,0.0,1.0
stitch picture,0,0,1,1,1.0,0.0,0.0
stop button,0,0,1,1,1.0,0.0,0.0
stoppage,1,0,0,1,0.0,0.0,1.0
storage capacity,1,0,0,1,0.0,0.0,1.0
storage space,0,0,1,1,1.0,0.0,0.0
store,0,1,1,2,0.5,0.5,0.0
store bags,0,0,1,1,1.0,0.0,0.0
strap,1,0,0,1,0.0,0.0,1.0
stream,0,0,1,1,1.0,0.0,0.0
sturdy,0,1,2,3,0.6666666666666666,0.3333333333333333,0.0
stylized,0,1,0,1,0.0,1.0,0.0
sub,1,0,0,1,0.0,0.0,1.0
sub woofer,1,0,1,2,0.5,0.0,0.5
subscription drmencoded,0,1,0,1,0.0,1.0,0.0
subscription wma,1,0,0,1,0.0,0.0,1.0
subwoofer,0,1,0,1,0.0,1.0,0.0
sunset feature,0,0,1,1,1.0,0.0,0.0
superdrive,0,0,1,1,1.0,0.0,0.0
support,23,7,4,34,0.11764705882352941,0.20588235294117646,0.6764705882352942
support service,1,0,0,1,0.0,0.0,1.0
surround sound,0,0,1,1,1.0,0.0,0.0
svideo,0,1,0,1,0.0,1.0,0.0
switch,0,3,3,6,0.5,0.5,0.0
switches,0,0,1,1,1.0,0.0,0.0
sygate,1,0,0,1,0.0,0.0,1.0
symantec,2,3,1,6,0.16666666666666666,0.5,0.3333333333333333
symantec customer service,0,1,0,1,0.0,1.0,0.0
symantect products,0,1,0,1,0.0,1.0,0.0
sync,0,5,1,6,0.16666666666666666,0.8333333333333334,0.0
sync to windows media player,0,0,1,1,1.0,0.0,0.0
sync with media player,0,0,1,1,1.0,0.0,0.0
syncing data,1,0,0,1,0.0,0.0,1.0
system,3,0,4,7,0.5714285714285714,0.0,0.42857142857142855
system error,1,0,0,1,0.0,0.0,1.0
systemworks,0,1,0,1,0.0,1.0,0.0
tag,0,2,0,2,0.0,1.0,0.0
tall,0,1,0,1,0.0,1.0,0.0
tech,1,2,0,3,0.0,0.6666666666666666,0.3333333333333333
tech line,1,0,0,1,0.0,0.0,1.0
tech support,2,2,3,7,0.42857142857142855,0.2857142857142857,0.2857142857142857
tech support people,0,1,0,1,0.0,1.0,0.0
technical service,1,0,0,1,0.0,0.0,1.0
technical support,1,2,2,5,0.4,0.4,0.2
text,0,0,1,1,1.0,0.0,0.0
text rendering,1,0,0,1,0.0,0.0,1.0
tft,1,0,0,1,0.0,0.0,1.0
tft screen,0,1,0,1,0.0,1.0,0.0
the unit,0,1,0,1,0.0,1.0,0.0
themes,0,1,0,1,0.0,1.0,0.0
thing,1,0,0,1,0.0,0.0,1.0
things,1,0,0,1,0.0,0.0,1.0
this,1,0,0,1,0.0,0.0,1.0
this item,1,0,0,1,0.0,0.0,1.0
this thing,1,2,0,3,0.0,0.6666666666666666,0.3333333333333333
tiff format,0,1,0,1,0.0,1.0,0.0
time,0,1,0,1,0.0,1.0,0.0
tiny,0,0,4,4,1.0,0.0,0.0
tivo,0,0,1,1,1.0,0.0,0.0
tmobile,2,7,4,13,0.3076923076923077,0.5384615384615384,0.15384615384615385
tmobile reception,1,0,0,1,0.0,0.0,1.0
tmobile service,2,0,1,3,0.3333333333333333,0.0,0.6666666666666666
tonal qualities,1,0,0,1,0.0,0.0,1.0
tone,1,0,2,3,0.6666666666666666,0.0,0.3333333333333333
tone side,0,0,1,1,1.0,0.0,0.0
tool,0,2,0,2,0.0,1.0,0.0
top,0,0,1,1,1.0,0.0,0.0
top loader,0,0,1,1,1.0,0.0,0.0
touch buttons,0,0,1,1,1.0,0.0,0.0
touch controls,0,0,1,1,1.0,0.0,0.0
touch pad,1,2,1,4,0.25,0.5,0.25
touch screen,0,1,0,1,0.0,1.0,0.0
touch sensitivity,1,0,0,1,0.0,0.0,1.0
touchpad,4,3,10,17,0.5882352941176471,0.17647058823529413,0.23529411764705882
touchpad controls,0,0,2,2,1.0,0.0,0.0
touchpad light,0,0,1,1,1.0,0.0,0.0
touchup,0,0,1,1,1.0,0.0,0.0
track record,1,0,0,1,0.0,0.0,1.0
transfer,5,9,4,18,0.2222222222222222,0.5,0.2777777777777778
transfer speed,0,1,1,2,0.5,0.5,0.0
transfter,0,1,0,1,0.0,1.0,0.0
transmission,0,1,0,1,0.0,1.0,0.0
transmission speed,0,0,1,1,1.0,0.0,0.0
transmit a signal,0,0,1,1,1.0,0.0,0.0
transporting,1,0,0,1,0.0,0.0,1.0
trash bag,0,0,1,1,1.0,0.0,0.0
trash bags,1,0,2,3,0.6666666666666666,0.0,0.3333333333333333
treble,0,0,2,2,1.0,0.0,0.0
trim,0,0,1,1,1.0,0.0,0.0
trnasfer,0,0,1,1,1.0,0.0,0.0
tune,0,1,0,1,0.0,1.0,0.0
tuner quality,0,0,1,1,1.0,0.0,0.0
txt file,0,0,1,1,1.0,0.0,0.0
typing experience,0,0,1,1,1.0,0.0,0.0
tzone,0,4,0,4,0.0,1.0,0.0
ultra slim monitor,0,1,0,1,0.0,1.0,0.0
unbox,0,0,1,1,1.0,0.0,0.0
underside,0,0,1,1,1.0,0.0,0.0
uninstall,4,0,1,5,0.2,0.0,0.8
uninstallation,0,1,0,1,0.0,1.0,0.0
unit,7,3,1,11,0.09090909090909091,0.2727272727272727,0.6363636363636364
units,1,0,0,1,0.0,0.0,1.0
universal remote control,1,0,0,1,0.0,0.0,1.0
unload,0,0,1,1,1.0,0.0,0.0
unresponsiveness,0,0,1,1,1.0,0.0,0.0
unstalling,0,1,0,1,0.0,1.0,0.0
update,0,3,0,3,0.0,1.0,0.0
updates,1,0,0,1,0.0,0.0,1.0
updating firmware,0,1,0,1,0.0,1.0,0.0
upgrade,3,1,1,5,0.2,0.2,0.6
upgradibility,0,0,1,1,1.0,0.0,0.0
uploading,0,1,0,1,0.0,1.0,0.0
upnp,0,1,0,1,0.0,1.0,0.0
usability,0,1,0,1,0.0,1.0,0.0
usage,0,1,0,1,0.0,1.0,0.0
usage with subscription service,0,1,0,1,0.0,1.0,0.0
usb,0,2,1,3,0.3333333333333333,0.6666666666666666,0.0
usb function,1,0,0,1,0.0,0.0,1.0
usb interface,0,1,0,1,0.0,1.0,0.0
usb network storage,0,0,1,1,1.0,0.0,0.0
usb port,3,0,1,4,0.25,0.0,0.75
usb recharge,1,0,0,1,0.0,0.0,1.0
use,14,35,23,72,0.3194444444444444,0.4861111111111111,0.19444444444444445
useable,0,1,1,2,0.5,0.5,0.0
used,0,0,2,2,1.0,0.0,0.0
user definable,0,0,1,1,1.0,0.0,0.0
user guide,0,0,1,1,1.0,0.0,0.0
user interface,2,2,2,6,0.3333333333333333,0.3333333333333333,0.3333333333333333
user manual,0,1,0,1,0.0,1.0,0.0
userinterfaces,0,0,1,1,1.0,0.0,0.0
users guide,0,1,0,1,0.0,1.0,0.0
using,1,0,0,1,0.0,0.0,1.0
valet plus,1,0,0,1,0.0,0.0,1.0
variety of colors,0,0,1,1,1.0,0.0,0.0
variety of colours,0,0,1,1,1.0,0.0,0.0
vcd,0,0,1,1,1.0,0.0,0.0
verizon,0,1,0,1,0.0,1.0,0.0
versatile,0,1,1,2,0.5,0.5,0.0
versatility,1,0,0,1,0.0,0.0,1.0
version 2004,0,2,0,2,0.0,1.0,0.0
vga connection,1,1,0,2,0.0,0.5,0.5
vibrate setting,0,0,2,2,1.0,0.0,0.0
vibration,1,1,2,4,0.5,0.25,0.25
video,4,2,4,10,0.4,0.2,0.4
video cable,0,0,1,1,1.0,0.0,0.0
video card,1,0,0,1,0.0,0.0,1.0
video format,0,0,1,1,1.0,0.0,0.0
video output,2,0,1,3,0.3333333333333333,0.0,0.6666666666666666
video quality,1,0,0,1,0.0,0.0,1.0
video recorder,1,1,0,2,0.0,0.5,0.5
video recorders,1,0,0,1,0.0,0.0,1.0
video recording,1,0,1,2,0.5,0.0,0.5
videoquality,0,0,1,1,1.0,0.0,0.0
view finder,0,0,1,1,1.0,0.0,0.0
viewfinder,5,3,5,13,0.38461538461538464,0.23076923076923078,0.38461538461538464
viewing angle,0,1,3,4,0.75,0.25,0.0
viewing angles,1,1,1,3,0.3333333333333333,0.3333333333333333,0.3333333333333333
visibility,0,2,0,2,0.0,1.0,0.0
visual backtracking,0,1,0,1,0.0,1.0,0.0
voice,0,0,1,1,1.0,0.0,0.0
voice dialing,2,0,3,5,0.6,0.0,0.4
voice quality,0,0,1,1,1.0,0.0,0.0
voice record,0,0,1,1,1.0,0.0,0.0
voice recorder,0,0,1,1,1.0,0.0,0.0
voice recorders,1,0,0,1,0.0,0.0,1.0
voice recording,1,0,1,2,0.5,0.0,0.5
voicedialing system,3,0,0,3,0.0,0.0,1.0
voip,0,0,1,1,1.0,0.0,0.0
volume adjustment,0,1,0,1,0.0,1.0,0.0
volume control,1,1,0,2,0.0,0.5,0.5
volume knob,0,0,1,1,1.0,0.0,0.0
volume level,1,0,0,1,0.0,0.0,1.0
volume levels,1,0,0,1,0.0,0.0,1.0
volume range,1,0,0,1,0.0,0.0,1.0
volumn,1,0,0,1,0.0,0.0,1.0
w,1,0,0,1,0.0,0.0,1.0
wait,0,1,1,2,0.5,0.5,0.0
wake up,0,1,2,3,0.6666666666666666,0.3333333333333333,0.0
wallpaper,0,2,0,2,0.0,1.0,0.0
warranty,1,2,3,6,0.5,0.3333333333333333,0.16666666666666666
warranty price,0,1,0,1,0.0,1.0,0.0
web browser,1,0,1,2,0.5,0.0,0.5
web site,0,0,1,1,1.0,0.0,0.0
weighs,0,0,1,1,1.0,0.0,0.0
wellpriced,0,1,0,1,0.0,1.0,0.0
wep encryption,0,0,1,1,1.0,0.0,0.0
wheel,0,0,2,2,1.0,0.0,0.0
white balance,0,1,1,2,0.5,0.5,0.0
white offset,0,0,1,1,1.0,0.0,0.0
wide,0,0,1,1,1.0,0.0,0.0
widescreen,0,1,0,1,0.0,1.0,0.0
widescreen monitors,0,0,1,1,1.0,0.0,0.0
windows 7 premium,0,1,0,1,0.0,1.0,0.0
windows compatibility,0,0,1,1,1.0,0.0,0.0
windows media,0,0,1,1,1.0,0.0,0.0
wipes,1,0,1,2,0.5,0.0,0.5
wire,0,0,1,1,1.0,0.0,0.0
wireless keyboard,0,0,1,1,1.0,0.0,0.0
wireless punch,0,0,1,1,1.0,0.0,0.0
wireless telephone,0,0,1,1,1.0,0.0,0.0
wizard,2,4,0,6,0.0,0.6666666666666666,0.3333333333333333
wma file,0,1,0,1,0.0,1.0,0.0
wma files,0,0,1,1,1.0,0.0,0.0
woofer,1,0,0,1,0.0,0.0,1.0
work,3,7,8,18,0.4444444444444444,0.3888888888888889,0.16666666666666666
work with wmp,1,0,0,1,0.0,0.0,1.0
worked,2,6,4,12,0.3333333333333333,0.5,0.16666666666666666
working,4,7,4,15,0.26666666666666666,0.4666666666666667,0.26666666666666666
workload,0,1,0,1,0.0,1.0,0.0
works,7,9,13,29,0.4482758620689655,0.3103448275862069,0.2413793103448276
wpa encryption,0,1,0,1,0.0,1.0,0.0
wrench,3,0,0,3,0.0,0.0,1.0
wrt54g,1,2,0,3,0.0,0.6666666666666666,0.3333333333333333
zen,0,3,2,5,0.4,0.6,0.0
zen micro,7,2,1,10,0.1,0.2,0.7
zen touch,0,1,0,1,0.0,1.0,0.0
zen xtra,0,2,0,2,0.0,1.0,0.0
zone alarm,1,0,0,1,0.0,0.0,1.0
zoom,2,2,4,8,0.5,0.25,0.25
zoom mode,1,0,0,1,0.0,0.0,1.0
zoom range,0,1,0,1,0.0,1.0,0.0
zoomed image,0,1,0,1,0.0,1.0,0.0
zooming lever,1,0,0,1,0.0,0.0,1.0
zooms,0,1,0,1,0.0,1.0,0.0
zx,0,1,0,1,0.0,1.0,0.0
